#######################################
# Syntax Coloring Map For Nova
#######################################

#######################################
# Datatypes (KEYWORD1)
#######################################
LED	KEYWORD1
Relay	KEYWORD1

Button	KEYWORD1

TiltSwitch	KEYWORD1
Vibration	KEYWORD1
ITR	KEYWORD1
Hall	KEYWORD1
LimitSwitch	KEYWORD1

Sound	KEYWORD1
FourButton	KEYWORD1
Light	KEYWORD1
Flame	KEYWORD1
MQ	KEYWORD1
Potentiometer	KEYWORD1

RGB	KEYWORD1
Buzzer	KEYWORD1
DigitDisplay	KEYWORD1
DHT	KEYWORD1
IRSendRev	KEYWORD1
Ultrasonic	KEYWORD1
RTC	KEYWORD1
Motor	KEYWORD1
Dual_Motor	KEYWORD1
LineFinder	KEYWORD1
NovaPort	KEYWORD1
#######################################
# Methods and Functions (KEYWORD2)
#######################################
state	KEYWORD2

on	KEYWORD2
off	KEYWORD2

cw	KEYWORD2
ccw	KEYWORD2

buttonAState	KEYWORD2
buttonBState	KEYWORD2
buttonCState	KEYWORD2
buttonDState	KEYWORD2

displayTime	KEYWORD2
displayNum	KEYWORD2
displayFloat	KEYWORD2
displayBit	KEYWORD2
displayABCDEF	KEYWORD2
clearBit	KEYWORD2
clear	KEYWORD2

tone	KEYWORD2

readTemperature	KEYWORD2
readHumidity	KEYWORD2
	
begin	KEYWORD2
recv	KEYWORD2
available	KEYWORD2
clear	KEYWORD2
send	KEYWORD2

distance	KEYWORD2

startClock	KEYWORD2
stopClock	KEYWORD2
setTime	KEYWORD2
getTime	KEYWORD2
getSecond	KEYWORD2
getMinute	KEYWORD2
getHour	KEYWORD2
getWeek	KEYWORD2
getDay	KEYWORD2
getMonth KEYWORD2
getYear	KEYWORD2
fillByHMS	KEYWORD2
fillByYMD	KEYWORD2
fillByWeek	KEYWORD2

run	KEYWORD2
stop	KEYWORD2

stateR	KEYWORD2
stateL	KEYWORD2
read	KEYWORD2

readAppKey	KEYWORD2

begin	KEYWORD2                
show	KEYWORD2
setPin	KEYWORD2
setPixelColor	KEYWORD2
setPixelColor	KEYWORD2
setPixelColor	KEYWORD2
setBrightness	KEYWORD2
clear	KEYWORD2
updateLength	KEYWORD2
updateType	KEYWORD2
getPixels	KEYWORD2
getBrightness	KEYWORD2
numPixels	KEYWORD2
Color	KEYWORD2
getPixelColor	KEYWORD2
canShow	KEYWORD2

getPin	KEYWORD2

#######################################
# Constants (LITERAL1)
#######################################
SS	LITERAL1
UL	LITERAL1
US	LITERAL1
UR	LITERAL1
LS	LITERAL1
RS	LITERAL1
DL	LITERAL1
DS	LITERAL1
DR	LITERAL1
AA	LITERAL1
BB	LITERAL1
CC	LITERAL1
DD	LITERAL1
ON	LITERAL1
OFF	LITERAL1

C0	LITERAL1
C1	LITERAL1

S0	LITERAL1
S1	LITERAL1
S2	LITERAL1
S3	LITERAL1

M0	LITERAL1
M1	LITERAL1
M2	LITERAL1
M3	LITERAL1

A0	LITERAL1
A1	LITERAL1
A2	LITERAL1
A3	LITERAL1

IR_BUTTON_0	LITERAL1
IR_BUTTON_1	LITERAL1
IR_BUTTON_2	LITERAL1
IR_BUTTON_3	LITERAL1
IR_BUTTON_4	LITERAL1
IR_BUTTON_5	LITERAL1
IR_BUTTON_6	LITERAL1
IR_BUTTON_7	LITERAL1
IR_BUTTON_8	LITERAL1
IR_BUTTON_9	LITERAL1
IR_BUTTON_OK	LITERAL1
IR_BUTTON_UP	LITERAL1
IR_BUTTON_DOWN	LITERAL1
IR_BUTTON_LEFT	LITERAL1
IR_BUTTON_RIGHT	LITERAL1
IR_BUTTON_SPARK	LITERAL1
IR_BUTTON_POUND	LITERAL1

L_IN_R_IN	LITERAL1
L_IN_R_OUT	LITERAL1
L_OUT_R_IN	LITERAL1
L_OUT_R_OUT	LITERAL1